000000001000000
000000001000000
000000001000000
000000001000000
000000001000000
000000001000000
000000000100000
000000000000000
000000000000000
000111000000000
000001000000000
000001000000000
000111000000100
000000000000010
000000000000001
000000111000000
000000111000000
000000000000000
000000000000000
000000000000000
