100010010000000
000000001000000
000000000100000
000000000000000
111000000000000
000000000000000
000000000000000
000000000000010
001000000000100
111000111111000
000000000000000
000000000000000
000000000000000
000000000000000
001000011100001
111000000000001
000000000000001
000000000000000
000000000000000
000000000000000