100000001100000
000000001100000
000000001100000
000000000000000
000000000000000
001000000000000
010000000000000
100000011100000
000000100000000
000000000000000
000000000000000
000000000000000
001000100010000
110000100010000
000000100010000
000000011100000
000000000000000
000000000000000
000000000000000
000000000000001